##################
#.......#........#
#.#G###.#.###.#..#
#.#.#.......#.#..#
#.#.#.###.###.#..#
#.....#...#......#
#.###.#.###.###.##
#...#.#.#.....#.@#
###.#.#.#.###.#..#
#...#.#.#...#.#..#
#.###.#.###.#.#..#
#.....#.....#....#
##################
